title: tiêu đề
property: sự thừa kế. nếu có sự thừa kế thì có thẻ ghi đè lên thẻ con
reference: tài liệu
heading: phần mở đầu
style: phong cách
semantic: ngữ nghĩa
target: mục tiêu
self: bản thân
blank: trống
rel(relationship): quan hệ
hash tag: dấu thăng
optional: không bắt buộc
requid: yêu cầu
cover: bao phủ
contain: chứa
column: cột
transform: biến đổi
notification: thông báo
badge: phù hiệu
item: mục
common: chung
description: mô tả
popular: phổ biến
info: thông tin
client:  khách hàng
arrow: mũi tên
label: nhãn
stats: số liệu thống kê
trend: xu hướng
separate: sự phân chia
quantity: số lượng
social: xã hội
copyright: bản quyền
summary: tóm tắt
primary: nguyên bản
rating: xếp hạng
Explore: khám phá
experience: kinh nghiệm
favourite : yêu thích
featured: đặc sắc
Achievement: thành tích
ourfit: trang phục
commerce: thương mại
delivery: vận chuyển
transaction: giao dịch
solution: giải pháp
contact: liên hệ
Resources: tài nguyên
feedback: phản hồi, nhận xét của khách hàng
slogan: khẩu hiệu
contact: liên hệ
search: tìm kiếm